A zombie apocalypse has taken over Brazil, the virus has spread rapidly through several cities in different ways, a soldier is sent to the Oswaldo Cruz Foundation (Fiocruz) to try to recover a cure (antidote) that was being developed by a brilliant researcher named Ada Lovelace . Your research may be Brazil's last hope. The soldier knows nothing about the current situation in the building.

Zombie Text
An Interactive Fiction by Felipe Melo, Herbert Salazar, Thiago Damasceno e Rodolpho Rosa
Release 1 / Serial number 181022 / Inform 7 build 6M62 (I6/v6.33 lib 6/12N) SD

Porch
The porch of Fiocruz is calm, quite different from the horrors that our soldier left behind until he gets there, the breeze hits his face as he prepares to enter.

You can see Main door here.

>enter main door
(first opening Main door)

Reception
reception description

You can see Main door, Hallway door, The Ax, and Cabinet (in which are Green key, Red key, Blue key, and Yellow key) here.

>take ax and green key
The Ax: Taken.
Green key: Taken.

>open hall door with ax
You unlock Hall door 1.

>enter hall door
(first opening Hall door 1)

Entry Hall
Hall 1 description

You can see Hall door 1, Lab door, Rest door, and Zombie 1 here.

>hit zombie with ax
You missed the blow but still managed to pull away to try again.

>open rest door with green key
You unlock Rest door.

>enter rest door
(first opening Rest door)
The zombie tries to attack you!

>take master key
You can't see any such thing.

>enter rest door
(first opening Rest door)
The zombie tries to attack you!

>enter lab door
(first opening Lab door)

Lab
Lab description

You see a big strong safe, that seems to be locked

You can also see Lab door and Hall door 2 here.

>open safe
It isn't something you can open.

>open safe with master key
You can't see any such thing.

>open safe with the master key
That doesn't seem to be something you can unlock.

* * *

>open safe with master key
You can't see any such thing.

>look
Lab
Lab description

You see a big strong safe, that seems to be locked

You can also see Lab door and Hall door 2 here.

>open safe with master key
You can't see any such thing.

>inventory
You are carrying:
  Green key
  The Ax

>enter lab door
Entry Hall
Hall 1 description

You can see Lab door, Hall door 1, Rest door, and Zombie 1 here.

>hit zombie with ax
You were not fast enough and the zombie attacks you.

    *** The End ***

Would you like to RESTART, RESTORE a saved game, QUIT, or UNDO the last command?

>undo
Entry Hall
[Previous turn undone.]

>hit zombie with ax
You missed the blow but still managed to pull away to try again.

>hit zombie with ax
You missed the blow but still managed to pull away to try again.

>hit zombie with ax
You hit the zombie with the ax right in the head. The ax gets stuck in the head of the zombie!

>open rest door with green key
That's unlocked at the moment.

>enter rest door
(first opening Rest door)

Rest room
Rest room description

You can see a man lying on the floor. He seems to be dead, apparently he shot himself in the head with a gun

You can also see Rest door here.

>take master key
You took the Master Key from the dead man's body

>enter rest door
Entry Hall
Hall 1 description

You can see Rest door, The Ax, Lab door, and Hall door 1 here.

>enter lab door
Lab
Lab description

You see a big strong safe, that seems to be locked

You can also see Lab door and Hall door 2 here.

>open safe with master key
That doesn't seem to be something you can unlock.

* * *

>enter lab door
(first opening Lab door)

Lab
Lab description

You see a big strong safe, that seems to be locked

You can also see Lab door and Hall door 2 here.

>undo
Entry Hall
[Previous turn undone.]

>look
Entry Hall
Hall 1 description

You can see Hall door 1, Lab door, Rest door, and Zombie 1 here.

* * *

>hit zombie with ax
You missed the blow but still managed to pull away to try again.

>undo
Entry Hall
[Previous turn undone.]

>hit zombie with ax
You hit the zombie with the ax right in the head. The ax gets stuck in the head of the zombie!

>hit zombie with ax
You hit the zombie with the ax right in the head. The ax gets stuck in the head of the zombie!

>open rest door with green key
You unlock Rest door.

>enter rest door
(first opening Rest door)

Rest room
Rest room description

You can see a man lying on the floor. He seems to be dead, apparently he shot himself in the head with a gun

You can also see Rest door here.

* * *

>take master key
You took the Master Key from the dead man's body

>enter rest door
Entry Hall
Hall 1 description

You can see Rest door, The Ax, Hall door 1, and Lab door here.

>enter lab door
(first opening Lab door)

Lab
Lab description

You see a big strong safe, that seems to be locked

You can also see Lab door and Hall door 2 here.

>open safe
It seems to be locked.

>open safe with master key
You unlock Safe.

>inventory
You are carrying:
  Master key
  Green key

>open safe with master key
That's unlocked at the moment.

>open safe with master key
That's unlocked at the moment.

* * *

>open rest door with green key
You unlock Rest door.

>enter rest door
(first opening Rest door)

Rest room
Rest room description

You can see a man lying on the floor. He seems to be dead, apparently he shot himself in the head with a gun

You can also see Rest door and Locker (closed) here.

>x man
The man has a gun in his right hand, some kind of special key and a wallet in his pocket and a note in his left hand

>x note
There is something wrote with a trembling letter: "Sorry for all the things I did, Amanda. With love, Charles Babbage"

>x wallet
"There is blood all over it. Was he bitten by a zombie?"

There is a badge in the wallet

>x badge
It's written: "Charles Babbage. FioCruz's Director". Looks like a kind of card.

>x locker
The lockers of all employees. They seem to be digital lockers that opens with some kind of card.

>take badge
It's written: "Charles Babbage. FioCruz's Director". Looks like a kind of card.

You took the badge from the wallet

>open locker
The lockers of all employees. They seem to be digital lockers that opens with some kind of card.

Opening Charles Babbage's Locker
It seems to be locked.

>open locker
The lockers of all employees. They seem to be digital lockers that opens with some kind of card.

Opening Charles Babbage's Locker
It seems to be locked.

* * *

>enter lab door
(first opening Lab door)

Lab
Lab description

You see a big strong safe, that seems to be locked

You can also see Lab door and Hall door 2 here.

>open safe
That's already open.

* * *

>hit zombie with ax
You missed the blow but still managed to pull away to try again.

>open rest door
It seems to be locked.

>open rest door with green key
You unlock Rest door.

* * *

>enter lab door
(first opening Lab door)

Lab
Lab description

You see a big strong safe, that seems to be locked

You can also see Lab door and Hall door 2 here.

>open safe
The safe seems locked.

>open safe with master key
You've unlocked the Safe, but it seems to have another security measurement.

>open safe
The safe seems to have a second security measurement, a fingerprint reader.

>open safe with master key
The safe seems to have a second security measurement, a fingerprint reader.

>open safe
The safe seems to have a second security measurement, a fingerprint reader.

* * *

>hit zombie with ax
You hit the zombie with the ax right in the head. The ax gets stuck in the head of the zombie!

>open rest door with geren key
You can't see any such thing.

>open rest door with geern key
You can't see any such thing.

>open rest door with green key
You unlock Rest door.

* * *

>enter rest door
(first opening Rest door)

Rest room
Rest room description

You can see a man lying on the floor. He seems to be dead, apparently he shot himself in the head with a gun

You can also see Rest door and Locker (closed) here.

>x locker
The lockers of all employees. They seem to be digital lockers that opens with some kind of card.

>open locker
It seems to be locked.

>x man
The man has a gun in his right hand, some kind of special key and a wallet in his pocket and a note in his left hand

* * *

>x wallet
"There is blood all over it. Was he bitten by a zombie?"

There is a badge in the wallet

>take badge
It's written: "Charles Babbage. FioCruz's Director". Looks like a kind of card.

You took the badge from the wallet

>open locker
It seems to be locked.

>open locker with badge
You open Charles Babbage's Locker. It's kinda messy! There is a bullet under the mess.

>x gun
It's written: "Desert Eagle Naga". There is no bullets in it.

>take gun
You took the gun from the dead man's body

>take bullet
You put the bullet in the gun and now it's charged

>inventory
You are carrying:
  a Gun
  Badge
  Green key

* * *

>enter rest door
(first opening Rest door)

Rest room
Rest room description

You can see a man lying on the floor. He seems to be dead, apparently he shot himself in the head with a gun

You can also see Rest door here.

>taka master key
That's not a verb I recognize.

>take master key
You took the Master Key from the dead man's body

* * *

>open safe with master key
You've unlocked the Safe, but it seems to have another security measurement.

>open safe
The safe seems locked.

* * *

>enter hall door
(first opening Hall door 1)

Entry Hall
Hall 1 description

You can see Hall door 1, Lab door, Rest door, and Zombie 1 here.

>git zombie with ax
That's not a verb I recognize.

>hit zombie with ax
You hit the zombie with the ax right in the head. The ax gets stuck in the head of the zombie!

* * *

>open safe
It seems to be locked.

>open safe with master key
That doesn't seem to fit the lock.

* * *

>enter hall door
(first opening Hall door 1)

Entry Hall
Hall 1 description

You can see Hall door 1, Lab door, Rest door, and Zombie 1 here.

>hit zombie with az
You can't see any such thing.

>hit zombie with ax
You missed the blow but still managed to pull away to try again.

* * *

>enter lab door
(first opening Lab door)

Lab
Lab description

You see a big strong safe, that seems to be locked

You can also see Lab door and Hall door 2 here.

>open safe with master key
That doesn't seem to be something you can unlock.

>open safe
You've unlocked the Safe, but it seems to have another security measurement.

>open safe
The safe seems to have a second security measurement, a fingerprint reader.

* * *

>enter hall door
(first opening Hall door 1)

Entry Hall
Hall 1 description

You can see Hall door 1, Lab door, Rest door, and Zombie 1 here.

>hit zombie with ax
You hit the zombie with the ax right in the head. The ax gets stuck in the head of the zombie!

* * *

>enter lab door
(first opening Lab door)

Lab
Lab description

You see a big strong safe, that seems to be locked

You can also see Lab door and Hall door 2 here.

>open safe
You've unlocked the Safe, but it seems to have another security measurement.

>open safe with master key
You unlock Safe.

>open safe with master key
That's unlocked at the moment.

* * *

>take ax and green key
The Ax: Taken.
Green key: Taken.

>unlock hall door with ax
You unlock Hall door 1.

>enter hall door
(first opening Hall door 1)

Entry Hall
Hall 1 description

You can see Hall door 1, Lab door, Rest door, and Zombie 1 here.

* * *

>open safe
It isn't something you can open.

>open safe with master key
You've unlocked the Safe, but it seems to have another security measurement.

* * *

>take ax and green key
The Ax: Taken.
Green key: Taken.

>open hall door ax
I only understood you as far as wanting to open Hall door 1.

>open hall door with ax
You unlock Hall door 1.

* * *

>enter rest door
(first opening Rest door)

Rest room
Rest room description

You can see a man lying on the floor. He seems to be dead, apparently he shot himself in the head with a gun

You can also see Rest door and Locker (closed) here.

>take bullet
You can't see any such thing.

>take gun
You took the gun from the dead man's body

>take bullet
You can't see any such thing.

>x locker
The lockers of all employees. They seem to be digital lockers that opens with some kind of card.

* * *

>enter main door
(first opening Main door)

Reception
reception description

You can see Main door, Hallway door, The Ax, and Cabinet (in which are Green key, Red key, Blue key, and Yellow key) here.

>open hall with ax
(first taking The Ax)
You unlock Hall door 1.

>enter hall
(first opening Hall door 1)

Entry Hall
Hall 1 description

You can see Hall door 1, Lab door, Rest door, and Zombie 1 here.

>enter rest
(first opening Rest door)
The zombie tries to attack you!

>open rest with green key
You can't see any such thing.

>enter hall
Reception
reception description

You can see Hall door 1, Main door, and Cabinet (in which are Green key, Red key, Blue key, and Yellow key) here.

>take green key
Taken.

>enter hall
Entry Hall
Hall 1 description

You can see Hall door 1, Lab door, Rest door, and Zombie 1 here.

>open rest with green key
You unlock Rest door.

>enter rest
(first opening Rest door)
The zombie tries to attack you!

* * *

>enter main door
(first opening Main door)

Reception
reception description

You can see Main door, Hallway door, The Ax, and Cabinet (in which are Green key, Red key, Blue key, and Yellow key) here.

>take cabinet
it's too heavy to carry

>inventory
You are carrying nothing.

>take ax and green key
The Ax: Taken.
Green key: Taken.

>open hall
The Hall door 1 is locked with a chain.

>open hall door with ax
You unlock Hall door 1.

>enter hall
(first opening Hall door 1)

Entry Hall
Hall 1 description

You can see Hall door 1, Lab door, Rest door, and Zombie 1 here.

>enter lab door
(first opening Lab door)
The zombie tries to attack you, before you get to the door!

>open lab door
The zombie tries to attack you, before you get to the door!

>hit zombie
You have to attack the zombie with something.

>hit zombie with ax
You missed the blow but still managed to pull away to try again.

>hit zombie with ax
You were not fast enough and the zombie attacks you.

    *** The End ***

Would you like to RESTART, RESTORE a saved game, QUIT, or UNDO the last command?

* * *

>hit zombie with ax
You hit the zombie with the ax right in the head. The ax gets stuck in the head of the zombie!

>inventory
You are carrying:
  Green key

>enter lab
(first opening Lab door)

Lab
Lab description

You see a big strong safe, that seems to be locked

You can also see Lab door and Hall door 2 here.

>enter hall door
(first opening Hall door 2)

Back Hall
Hall 2 description

You can see Hall door 2, Refectory door, Zombie 2, and Zombie 3 here.

>hit zombie 3
Violence isn't the answer to this one.

* * *

>take cabinet
it's too heavy to carry

>take ax and green and red
The Ax: Taken.
Green key: Taken.
Red key: Taken.

>open hall with ax
You unlock Hall door 1.

>enter hall
(first opening Hall door 1)

Entry Hall
Hall 1 description

You can see Hall door 1, Lab door, Rest door, and Zombie 1 here.

>hit zombie with ax
You missed the blow but still managed to pull away to try again.

* * *

>hit zombie with ax
You hit the zombie with the ax right in the head. The ax gets stuck in the head of the zombie!

>take ax
Taken.

>open rest with green key
You unlock Rest door.

>enter rest
(first opening Rest door)

Rest room
Rest room description

You can see a man lying on the floor. He seems to be dead. He apparently shot himself in the head with a gun

You can also see Rest door and Locker (closed) here.

>x wallet
"There is blood all over it. Was he bitten by a zombie?"

There is a badge in the wallet

* * *

>take badge
It's written: "Charles Babbage. FioCruz's Director". Looks like a kind of card.

You took the badge from the wallet

>take gun
You took the gun from the dead man's body

>open locker with badge
You open Charles Babbage's Locker. It's kinda messy! There is a bullet under the mess.

>take bullet
You put the bullet in the gun and now it's charged

>take master
You took the Master Key from the dead man's body

>enter rest
Entry Hall
Hall 1 description

You can see Rest door, Hall door 1, and Lab door here.

>enter lab
(first opening Lab door)

Lab
Lab description

You see a safe that seems to be locked

You can also see Lab door and Hall door 2 here.

>exit lab
I only understood you as far as wanting to exit.

>open safe with master
You've unlocked the Safe, but it seems to have another security measure.

>enter hall
(first opening Hall door 2)

Back Hall
Hall 2 description

You can see Hall door 2, Refectory door, Zombie 2, and Zombie 3 here.

>hit zombie with gun
Who do you mean, Zombie 2 or Zombie 3?

>2
You shot the zombie and now you are out of gun

>hit zombie with ax
You hit the zombie with the ax right in the head. The ax gets stuck in the head of the zombie!

* * *

>take ax
Taken.

>open refectori with red
You can't see any such thing.

>open refectory with red
You unlock Refectory door.

>enter refectory
(first opening Refectory door)

Refectory
Refectory description

You can see Refectory door and Ada Lovelace here.

>talk to ada
you: "Are you alright? Were you bitten? Do you know where the antidote is?" 

 Ada: "I'm fine. You can rest easy,". 

 You take a deep breath and try to calm down. 

 you: "I've been through hell to get here and i don't even know if the antidote is safe." 

 Ada: "Don't worry about that, the antidote is here and safe."

>ask about antidote
You can't see any such thing.

>ask about the antidote
You can't see any such thing.

>ask about antidote
You can't see any such thing.

>ask her about antidote
There is no reply.

>ask her about the antidote
"The antidote is in the laboratory in a locked safe" 

 "To access it you need a master key that is with the FioCruz's director and then you'll need my fingerprint" she says to him

>carry ada
Lab
Lab description

You see a safe that seems to be locked

You can also see Hall door 2, Ada Lovelace, and Lab door here.

* * *

>enter main door
(first opening Main door)

Reception
reception description

You can see Main door, Hallway door, The Ax, and Cabinet (in which are Green key, Red key, Blue key, and Yellow key) here.

>take ax
Taken.

>open hallway with ax
You unlock Hallway door.

>enter hallway
(first opening Hallway door)

Hallway
The hallway is large with high walls, which seem even larger with the silence and the absence of people.

Stand by the Rest door you see a living dead who was once probably an employee of that institution. On the outside he wears this gray skin and hungry eyes.

You can also see Hallway door, Lab door, and Rest door here.

>hit zombie with ax
You hit the zombie with the ax right in the head. The ax gets stuck in the head of the zombie!

* * *

>take ax
Taken.

>open lab door
You open Lab door.

>enter lab
Laboratory
The Laboratory is quite big, with lots of equipments and machines.

You see a safe that seems to be locked

You can also see Lab door and Hall door here.

* * *

>enter main
(first opening Main door)

Reception
The reception is deserted, a deafening silence takes over the place.

You can see Main door, Hallway door, The Ax, and Cabinet (in which are Green key, Red key, Blue key, and Yellow key) here.

>take ax and green key
The Ax: Taken.
Green key: Taken.

>open hall with ax
You unlock Hall door 1.

* * *

>enter hall
(first opening Hall door 1)

Entry Hall
Hall 1 description

You can see Hall door 1, Lab door, Rest door, and Zombie 1 here.

>hit zombie with ax
You were not fast enough and the zombie attacks you.

    *** The End ***

Would you like to RESTART, RESTORE a saved game, QUIT, or UNDO the last command?

>hit zombie with ax
Please give one of the answers above.

Would you like to RESTART, RESTORE a saved game, QUIT, or UNDO the last command?

>hit zombie with ax
Please give one of the answers above.

Would you like to RESTART, RESTORE a saved game, QUIT, or UNDO the last command?

>open rest with green
Please give one of the answers above.

Would you like to RESTART, RESTORE a saved game, QUIT, or UNDO the last command?

>enter rest
Please give one of the answers above.

Would you like to RESTART, RESTORE a saved game, QUIT, or UNDO the last command?

>take gun
Please give one of the answers above.

Would you like to RESTART, RESTORE a saved game, QUIT, or UNDO the last command?

>take badge
Please give one of the answers above.

Would you like to RESTART, RESTORE a saved game, QUIT, or UNDO the last command?

>x wallet
Please give one of the answers above.

Would you like to RESTART, RESTORE a saved game, QUIT, or UNDO the last command?

>take badge
Please give one of the answers above.

Would you like to RESTART, RESTORE a saved game, QUIT, or UNDO the last command?

>open locker with badge
Please give one of the answers above.

Would you like to RESTART, RESTORE a saved game, QUIT, or UNDO the last command?

>take bullet
Please give one of the answers above.

Would you like to RESTART, RESTORE a saved game, QUIT, or UNDO the last command?

>enter rest
Please give one of the answers above.

Would you like to RESTART, RESTORE a saved game, QUIT, or UNDO the last command?

>enter lab
Please give one of the answers above.

Would you like to RESTART, RESTORE a saved game, QUIT, or UNDO the last command?

>open safe
Please give one of the answers above.

Would you like to RESTART, RESTORE a saved game, QUIT, or UNDO the last command?

>enter lab
Please give one of the answers above.

Would you like to RESTART, RESTORE a saved game, QUIT, or UNDO the last command?

>enter rest
Please give one of the answers above.

Would you like to RESTART, RESTORE a saved game, QUIT, or UNDO the last command?

>take master key
Please give one of the answers above.

Would you like to RESTART, RESTORE a saved game, QUIT, or UNDO the last command?

>enter rest
Please give one of the answers above.

Would you like to RESTART, RESTORE a saved game, QUIT, or UNDO the last command?

* * *

>enter lab
Please give one of the answers above.

Would you like to RESTART, RESTORE a saved game, QUIT, or UNDO the last command?

>open safe with master key
Please give one of the answers above.

Would you like to RESTART, RESTORE a saved game, QUIT, or UNDO the last command?

>enter hall
Please give one of the answers above.

Would you like to RESTART, RESTORE a saved game, QUIT, or UNDO the last command?

>hit zombie 2 with gun
Please give one of the answers above.

Would you like to RESTART, RESTORE a saved game, QUIT, or UNDO the last command?

>undo
Entry Hall
[Previous turn undone.]

>hit zombie 2 with gun
I only understood you as far as wanting to hit Zombie 1.

>hit zombie with ax
You missed the blow but still managed to pull away to try again.

>enter lab
(first opening Lab door)
The zombie tries to attack you, before you get to the door!

>enter hall
Reception
reception description

You can see Hall door 1, Main door, and Cabinet (in which are Red key, Blue key, and Yellow key) here.

>enter lab
You can't see any such thing.

>take ax
You already have that.

>enter lab
You can't see any such thing.

>enter hall
Entry Hall
Hall 1 description

You can see Hall door 1, Lab door, Rest door, and Zombie 1 here.

>hit zombie with ax
You missed the blow but still managed to pull away to try again.

* * *

>enter lab
(first opening Lab door)
The zombie tries to attack you, before you get to the door!

>enter lab
(first opening Lab door)
The zombie tries to attack you, before you get to the door!

* * *

>enter hall
Entry Hall
Hall 1 description

You can see Hall door 1, Lab door, Rest door, and Zombie 1 here.

>take red key
You can't see any such thing.

>enter hall
Reception
reception description

You can see Hall door 1, Main door, and Cabinet (in which are Red key, Blue key, and Yellow key) here.

* * *

>enter hall
Entry Hall
Hall 1 description

You can see Hall door 1, Lab door, Rest door, and Zombie 1 here.

>enter refectory
You can't see any such thing.

>open refectory with red
You can't see any such thing.

>enter refectory
You can't see any such thing.

>talk to Ada
You can't see any such thing.

>where is the antidote?
That's not a verb I recognize.

>where is the cure?
That's not a verb I recognize.

>where is the antidote?
That's not a verb I recognize.

>the cure
That's not a verb I recognize.

>ask about the antidote
You can't see any such thing.

>ask about the cure
You can't see any such thing.

>ask her about the antidote
I'm not sure what 'her' refers to.

>ask her about the antidote
I'm not sure what 'her' refers to.

* * *

>ask her about the antidote
There is no reply.

>ask her about the antidote
There is no reply.

>ask her about the cure
"The antidote is in the laboratory in a locked safe" 

 "To access it you need a master key that is with the FioCruz's director and then you'll need my fingerprint" she says to him

>carry her
Lab
Lab description

You see a safe that seems to be locked

You can also see Hall door 2, Ada Lovelace, and Lab door here.

>open safe
Ada opens the Safe with her fingerprint. The Safe is now open and you can see the antidote inside it.

>take antidote
You took the antidote, handled it to responsible officers and saved the mankind.

    *** The End ***

Would you like to RESTART, RESTORE a saved game, QUIT, or UNDO the last command?

* * *

>enter main
(first opening Main door)

Reception
The reception is deserted, a deafening silence takes over the place.

You can see Main door, Hallway door, The Ax, and Cabinet (in which are Green key, Red key, Blue key, and Yellow key) here.

>x ax
An ax with wooden handle, looks new.

>open hall door with ax
(first taking The Ax)
You unlock Hall door 1.

>enter hall
(first opening Hall door 1)

Entry Hall
Hall 1 description

A living dead who was once probably an employee of that institution. On the outside he wears this gray skin and hungry eyes.

You can also see Hall door 1, Lab door, and Rest door here.

* * *

>enter main
(first opening Main door)

Reception
The reception is deserted, a deafening silence takes over the place.

You can see Main door, Hallway door, The Ax, and Cabinet (in which are Green key, Red key, Blue key, and Yellow key) here.

>take ax and green keu and red keu
I only understood you as far as wanting to take those things.

>take ax and green keu and red keu
I only understood you as far as wanting to take those things.

>take ax and green key and red
The Ax: Taken.
Green key: Taken.
Red key: Taken.

>open hallway with ax
You unlock Hallway door.

* * *

>enter hallway
(first opening Hallway door)

Hallway
The hallway is large with high walls, which seem even larger with the silence and the absence of people.

Stand by the Rest door you see a living dead who was once probably an employee of that institution. On the outside he wears this gray skin and hungry eyes.

You can also see Hallway door, Lab door, and Rest door here.

>enter lab door
(first opening Lab door)
The zombie tries to attack you, before you get to the door!

>open rest door with green key
You unlock Rest door.

>enter rest
(first opening Rest door)
The zombie tries to attack you, before you get to the door!

>hit zombie with ax
You hit the zombie with the ax right in the head. The ax gets stuck in the head of the zombie!

>enter rest
(first opening Rest door)

Rest room
The rest room is a large room with comfortable chairs, but blood stains, showing that it was no longer a safe and comfortable place like before.

You can see a man lying on the floor. He seems to be dead. He apparently shot himself in the head with a gun

You can also see Rest door and Locker (closed) here.

>x man
The man has a gun in his right hand, some kind of special key, a wallet in his pocket and a note in his left hand

>x note
There is something written in a trembling handwriting:

 "I try to makes things right and i fail, i'm sorry Amanda. 

 With love, Charles Babbage"

>x gun
It's written: "Desert Eagle Naga". There is no bullets in it.

* * *

>take gun
You took the gun from the dead man's body

>x locker
The lockers of all the employees. They seem to be digital lockers that open with some kind of card.

>take badge
You can't see any such thing.

>x wallet
"There is blood all over it. Was he bitten by a zombie?"

There is a badge in the wallet

* * *

>x badge
It's written: "Charles Babbage. FioCruz's Director". Looks like a kind of card.

>take badge
It's written: "Charles Babbage. FioCruz's Director". Looks like a kind of card.

You took the badge from the wallet

* * *

>take bullet
You put the bullet in the gun and now it's charged

>take bullet
You can't see any such thing.

>look
Rest room
The rest room is a large room with comfortable chairs, but blood stains, showing that it was no longer a safe and comfortable place like before.

You can see a man lying on the floor. He seems to be dead. He apparently shot himself in the head with a gun

You can also see Rest door and Locker (empty) here.

>enter rest
Hallway
The hallway is large with high walls, which seem even larger with the silence and the absence of people.

You can see Rest door, The Ax, Hallway door, and Lab door here.

>enter lab
(first opening Lab door)

Laboratory
The Laboratory is quite big, with lots of equipments and machines.

You see a safe that seems to be locked

You can also see Lab door and Hall door here.

>open safe
The safe seems locked.

>enter hall
(first opening Hall door)

Hall
The hall is long and with pictures of famous scientists who passed through the institution

You can see Hall door, Refectory door, Zombie 2, and Zombie 3 here.

>ex zombie 2
That's not a verb I recognize.

>x zombie 2
You see nothing special about Zombie 2.

* * *

>enter main
(first opening Main door)

Reception
The reception is deserted, a deafening silence takes over the place.

You can see Main door, Hallway door, The Ax, and Cabinet (in which are Green key, Red key, Blue key, and Yellow key) here.

>take ax and green and red
The Ax: Taken.
Green key: Taken.
Red key: Taken.

>open hallway with ax
You unlock Hallway door.

>enter hallway
(first opening Hallway door)

Hallway
The hallway is large with high walls, which seem even larger with the silence and the absence of people.

Standing by the Rest door you see a living dead who was once probably an employee of that institution. On the outside he wears this gray skin and hungry eyes.

You can also see Hallway door, Lab door, and Rest door here.

>hit zombie with ax
You hit the zombie with the ax right in the head. The ax gets stuck in the head of the zombie!

* * *

>take ax
Taken.

>open rest with green
You unlock Rest door.

>enter rest
(first opening Rest door)

Rest room
The rest room is a large room with comfortable chairs, but blood stains, showing that it was no longer a safe and comfortable place like before.

You can see a man lying on the floor. He seems to be dead. He apparently shot himself in the head with a gun

You can also see Rest door and Locker (closed) here.

* * *

>x man
The man has a gun in his right hand, some kind of special key, a wallet in his pocket and a note in his left hand

>x wallet
"There is blood all over it. Was he bitten by a zombie?"

There is a badge in the wallet

* * *

>take bullet
You put the bullet in the gun and now it's charged

>take master key
You took the Master Key from the dead man's body

>enter rest
Hallway
The hallway is large with high walls, which seem even larger with the silence and the absence of people.

You can see Rest door, Hallway door, and Lab door here.

>enter lab
(first opening Lab door)

Laboratory
The Laboratory is quite big, with lots of equipments and machines.

You see a safe that seems to be locked

You can also see Lab door and Hall door here.

>open safe with master
You've unlocked the Safe, but it seems to have another security measure.

>enter hall
(first opening Hall door)

Hall
The hall is long and with pictures of famous scientists who passed through the institution

Standing by the Refectory door you see one of the undead scratching the Refectory door, as he was hunting something or someone.

There is another creature, a big man with the same hungry eye that they always have.

You can also see Hall door and Refectory door here.

>hit zombie
Who do you mean, Zombie 2 or Zombie 3?

>2
You have to attack the zombie with something.

>hit zombie with gun
Who do you mean, Zombie 2 or Zombie 3?

>2
You missed the shot and now you're out of bullets. The zombies attack you.

    *** The End ***

Would you like to RESTART, RESTORE a saved game, QUIT, or UNDO the last command?

>undo
Hall
[Previous turn undone.]

>hit zombie with gun
Who do you mean, Zombie 2 or Zombie 3?

* * *

>hit zombie with ax
You hit the zombie with the ax right in the head. The ax gets stuck in the head of the zombie!

>open refectory with red
You unlock Refectory door.

>enter refectory
(first opening Refectory door)

Refectory
The refectory is a place with long tables surrounded by chairs

You can see Refectory door and Ada Lovelace here.

>talk to ada
you: "Are you alright? Were you bitten? Do you know where the antidote is?" 

 Ada: "Thank's God you are here. I was so scary. Did you kill the zombies out side?". 

 You: "Yeah it was not easy.". 

 You take a deep breath and try to calm down. 

 you: "I've been through hell to get here and i don't even know if the antidote is safe." 

 Ada: "Don't worry about that, the antidote is here and safe."

>ask her about antidote
There is no reply.

>ask her about the antidote
Ada: "The antidote is in the laboratory in a locked safe" 

 Ada: "To access it you need a master key that is with the FioCruz's director and then you'll need my fingerprint"

Ada: "Follow me""

>follow ada
Laboratory
The Laboratory is quite big, with lots of equipments and machines.

You see a safe that seems to be locked

You can also see Hall door, Ada Lovelace, and Lab door here.

>open safe
Ada opens the Safe with her fingerprint. The Safe is now open and you can see the antidote inside it.

* * *

>x man
The man has a gun in his right hand, some kind of special key, a wallet in his pocket and a note in his left hand

>take master key
You took the Master Key from the dead man's body

>take badge
You can't see any such thing.

* * *

>take bullet
You put the bullet in the gun and now it's charged

>enter rest
Hallway
The hallway is large with high walls, which seem even larger with the silence and the absence of people.

You can see Rest door, Hallway door, and Lab door here.

* * *

>open safe
The safe seems locked.

>open safe with master key
You've unlocked the Safe, but it seems to have another security measure.

>enter hall
(first opening Hall door)

Hall
The hall is long and with pictures of famous scientists who passed through the institution

Standing by the Refectory door you see one of the undead scratching the Refectory door, as he was hunting something or someone.

There is another creature, a big man with the same hungry eye that they always have.

You can also see Hall door and Refectory door here.

>hit zombie 1 with gun
Who do you mean, Zombie 2 or Zombie 3?

>2
I only understood you as far as wanting to hit Zombie 2.

>hit zombie with gun
Who do you mean, Zombie 2 or Zombie 3?

* * *

>open refectory with red
You unlock Refectory door.

>enter refectory
(first opening Refectory door)

Refectory
The refectory is a place with long tables surrounded by chairs

You see a beautiful woman with a coat, when she turns you can see her name on it, Ada Lovelace.

You can also see Refectory door here.

>talk to her
you: "Are you alright? Were you bitten? Do you know where the antidote is?" 

 Ada: "Thank's God you are here. I was so scary. Did you kill the zombies out side?". 

 You: "Yeah it was not easy.". 

 You take a deep breath and try to calm down. 

 you: "I've been through hell to get here and i don't even know if the antidote is safe." 

 Ada: "Don't worry about that, the antidote is here and safe."

>ask her about antidote
Ada: "The antidote is in the laboratory in a locked safe" 

 Ada: "To access it you need a master key that is with the FioCruz's director and then you'll need my fingerprint"

Ada: "Follow me""

>follow her
Laboratory
The Laboratory is quite big, with lots of equipments and machines.

You see a beautiful woman with a coat, when she turns you can see her name on it, Ada Lovelace.

You see a safe that seems to be locked

You can also see Hall door and Lab door here.

>open safe
Ada opens the Safe with her fingerprint. The Safe is now open and you can see the antidote inside it.

* * *

>take antidote
You took the antidote, handled it to responsible officers and saved the mankind.

    *** The End ***

Would you like to RESTART, RESTORE a saved game, QUIT, or UNDO the last command?

>quit
[ The game has finished ]

* * *

>verbs
That's not a verb I recognize.

>actions
Actions listing on.

>actions
Actions listing on.

* * *

I beg your pardon?

>open the door
You open Main door.

>enter
You must supply a noun.

>enter the door
Reception
The reception is deserted, a deafening silence takes over the place.

You can see Main door, Hallway door, The Ax, and Cabinet (in which are Green key, Red key, Blue key, and Yellow key) here.

>take the Yellow key
Taken.

>open the Hallway door
It seems to be locked.

>take the Green key
Taken.

>take the Red and Blue key
Red key: Taken.
Blue key: Taken.

>open the Hallway door
It seems to be locked.

>open the Hallway door with the Yellow key
That doesn't seem to fit the lock.

>take the Ax
Taken.

>open the Hallway door with the Ax
You unlock Hallway door.

>enter the Hallway door
(first opening Hallway door)

Hallway
The hallway is large with high walls, which seem even larger with the silence and the absence of people.

Standing by the Rest door you see a living dead who was once probably an employee of that institution. On the outside he wears this gray skin and hungry eyes.

You can also see Hallway door, Lab door, and Rest door here.

>enter the Lab door
(first opening Lab door)
The zombie tries to attack you, before you get to the door!

>use Ax
That's not a verb I recognize.

>attack
What do you want to attack?

>Zombies
You can't see any such thing.

>Zombie
That's not a verb I recognize.

>attack
What do you want to attack?

>zombie
You have to attack the zombie with something.

>attack zombie with Ax
You missed the blow but still managed to pull away to try again.

>attack zombie with Ax
You hit the zombie with the ax right in the head. The ax gets stuck in the head of the zombie!

>look
Hallway
The hallway is large with high walls, which seem even larger with the silence and the absence of people.

You can see The Ax, Hallway door, Lab door, and Rest door here.