introduction to be written
zumbi text
An Interactive Fiction by Felipe Melo
Release 1 / Serial number 181020 / Inform 7 build 6M62 (I6/v6.33 lib 6/12N) SD

Porch
porch description

You can see Main door here.

>open main door
You open Main door.

>look
Porch
You can see Main door here.

>enter main door
Reception
You can see Main door here.

>look
Reception
You can see Main door here.

>up
You can't go that way.

* * *

>open main door
You open Main door.

>enter main door
Reception
reception description

You can see Main door, Hall door 1, The Crowbar, and Cabinet (in which are Green key, Red key, Blue key, and Yellow key) here.

>open Hall door
You open Hall door.

>enter hall door
Hall 1
You can see Hall door and Rest door here.

>open rest door
You open Rest door.

>enter rest door
Hall 1
You can see Hall door and Rest door here.

>enter rest door
Hall 1
You can see Hall door and Rest door here.

* * *

>enter main door
Reception
reception description

You can see Main door, Hall door 1, The Crowbar, and Cabinet (in which are Green key, Red key, Blue key, and Yellow key) here.

>open hall door
You open Hall door.

>enter hall door
Hall 1
You can see Hall door and Rest door here.

* * *

>open rest door
You open Rest door.

>enter rest door
Rest Room
You can see Rest door here.

>enter rest door
Hall 1
You can see Rest door and Hall door here.

* * *

>enter main door
Reception
reception description

You can see Main door, Hall door 1, The Crowbar, and Cabinet (in which are Green key, Red key, Blue key, and Yellow key) here.

>open hall door 1
You open Hall door 1.

>enter hall door 1
Hall 1
You can see Hall door 1, Lab door and Rest door here.

>open rest door
You open Rest door.

* * *

>enter rest door
Rest Room
You can see Rest door here.

>enter rest door
Hall 1
You can see Rest door, Hall door 1 and Lab door here.

>open lab door
You open Lab door.

>enter lab
Lab
You can see Lab door and Hall door 2 here.

>open hall door 2
You open Hall door 2.

>enter hall 2
Hall 2
You can see Hall door 2 and Refectory door here.

>open refectory door
You open Refectory door.

>enter refectory
Hall 2
You can see Hall door 2 and Refectory door here.

* * *

>enter main door
Reception
reception description

You can see Main door, Hall door 1, The Crowbar, and Cabinet (in which are Green key, Red key, Blue key, and Yellow key) here.

>take Crowbar
Taken.

>invetory
That's not a verb I recognize.

>inventory
You are carrying:
  Crowbar

* * *

>enter main door
Reception
reception description

You can see Main door, Hall door 1, The Crowbar, and Cabinet (in which are Green key, Red key, Blue key, and Yellow key) here.

>open Hall door 1
It seems to be locked.

>take the red key from the cabinet
Taken.

>open hall door 1 with red key
That doesn't seem to fit the lock.

>take the green key from the cabinet
Taken.

>open hall door 1 with green key
That doesn't seem to fit the lock.

* * *

>enter main door
Reception
reception description

You can see Main door, Hall door 1, The Crowbar, and Cabinet (in which are Green key, Red key, Blue key, and Yellow key) here.

>take crowbar, green key, and red key
You can't see any such thing.

>take crowbar and green key and red key
The Crowbar: Taken.
Green key: Taken.
Red key: Taken.

>open hall door 1 with crowbar
You unlock Hall door 1.

>enter hall door 1
(first opening Hall door 1)

Entry Hall
Hall 1 description

You can see Hall door 1, Lab door, Rest door, and Zombie 1 here.

>open rest room with green key
I only understood you as far as wanting to open Rest door.

>open rest door with green key
You unlock Rest door.

>enter rest door
(first opening Rest door)

Rest room
Rest room description

He seems to be dead

You can also see Rest door here.

* * *

introduction to be written
zumbi text
An Interactive Fiction by Felipe Melo
Release 1 / Serial number 181020 / Inform 7 build 6M62 (I6/v6.33 lib 6/12N) SD

Porch
porch description

You can see Main door here.

>enter main door
(first opening Main door)

Reception
reception description

You can see Main door, Hall door 1, The Crowbar, and Cabinet (in which are Green key, Red key, Blue key, and Yellow key) here.

>enter main door
Porch
You can see Main door here.

>open Main door
That's already open.

>enter main door
Reception
You can see Main door and Enter door here.

>open Enter door
You open Enter door.

>enter Enter door
Hall 1
You can see Enter door here.

* * *

>enter main door
(first opening Main door)

Reception
reception description

You can see Main door, Hall door 1, The Crowbar, and Cabinet (in which are Green key, Red key, Blue key, and Yellow key) here.

>take crowbar
Taken.

>take Red key and Green key
Red key: Taken.
Green key: Taken.

>look
Reception
reception description

You can see Main door, Hall door 1, and Cabinet (in which are Blue key and Yellow key) here.

>open Hall door 1
It seems to be locked.

>open the hall door 1 with red key
That doesn't seem to fit the lock.

>open the hall door 1 with green key
That doesn't seem to fit the lock.

>open the hall door 1 with crowbar
You unlock Hall door 1.

>enter hall door 1
(first opening Hall door 1)

Entry Hall
Hall 1 description

You can see Hall door 1, Lab door, Rest door, and Zombie 1 here.

>open rest door with green key
You unlock Rest door.

>enter rest door
(first opening Rest door)

Rest room
Rest room description

You can see Rest door and Charles Babbage (in which is Gun) here.

* * *

>enter main door
(first opening Main door)

Reception
reception description

You can see Main door, Hall door 1, The Crowbar, and Cabinet (in which are Green key, Red key, Blue key, and Yellow key) here.

>take crowbar and green key and red key
The Crowbar: Taken.
Green key: Taken.
Red key: Taken.

* * *

>open rest door with green key
You unlock Rest door.

>enter rest door
(first opening Rest door)

Rest room
Rest room description

You can see a man named as Charles Babbage in the floor, he seems to be dead, in his badge says that he was FioCruz'd director, apparently he shot himself in the head with a gun because he was bitten by a zombie

You can also see Rest door here.

>x Charles Babbage
Charles Babbage is carrying a gun and a key

>take the gun from Charles Babbage
That seems to belong to Charles Babbage.

* * *

>enter main door
(first opening Main door)

Reception
reception description

You can see Main door, Hall door 1, The Crowbar, and Cabinet (in which are Green key, Red key, Blue key, and Yellow key) here.

>take crowbar and green key
The Crowbar: Taken.
Green key: Taken.

>open hall door 1 with crowbar
You unlock Hall door 1.

* * *

>enter hall door 1
(first opening Hall door 1)

Entry Hall
Hall 1 description

You can see Hall door 1, Lab door, Rest door, and Zombie 1 here.

>attack the zombie with crowbar
You hit the zombie with the crowbar right in the head. The crowbar gets stuck in the head of the zombie!

>inventory
You are carrying:
  Green key

>look
Entry Hall
Hall 1 description

You can see The Crowbar, Hall door 1, Lab door, and Rest door here.